11111
1PNE1
1C001
10011
10011
10N01
1C001
11011
10011
10N01
1C001
11011
10011
10001
11111