111111111111
100000C00C01
100000E00001
10C111011111
100111111111
110111111111
1P0000C00C01
100000000001
10C111011111
101111111111
100000C00C01
100000000001
10C111011111
101111111111
100000C00C01
100000000001
10C111011111
111111111111