111111111111
100000C10C01
100P00E10001
11C111011111
111111111111