0011111111111111111
100C000000000111111
1000011111111111111
1111111111111111111