0011111111111111111
100P0C000C000111111
11E0011111110111111
1111111111111111111