1111111111111111110
1000000000000111111
1000011111111111111
1111111111111111111