111111111111
1E000PC00C01
11C111111111
111111111111