11111111111111
11111111111C11
11111111111111
1P1111E1111111