111111111111
10000PC10C01
100000E00001
11C111111111
111111111111