111111111111111111
1P0000000000C0E0C1
111111111111111111