0011111111111111111
10C0000000000111111
1000011111111111111
1111111111111111111
