11111111111111
0C000000000001
10000010000001
11111111111111
